000000000000000000000000000000
000000000000000000000000000000
000000000000000000000000000000
00000000000H0000000000H0000000
00#########H##########H##00000
00#########H##########H##00000
00000000000H0000000000H0000000
00000000000H0000000000H0000000
00000000000H0000000000H0000H00
00000000000H0000000000#####H##
00000000000H000000000000000H00
00000000000H000000000000000H00
0000H000000H000000H00000000H00
000#H#############H##000000H00
0000H#############H00000000H00
0000H0000000000000H00000000H00
0000H0000000000000H00000000H00
0000H0000000000000H00000000H00
0000H0000000000000H00000000H00
000###00000000000###0000000###