000000000000000000000000000000
000000000000000000000000000000
000000000000000000000000000000
000000000000000000000000000000
000000000000000000000000000000
000000000000000000000000000000
000000000000000000000000000000
000000000000000000000000000000
000H0000000000000000000000H000
000H######################H000
000H0000000000000000000000H000
000H0000000000000000000000H000
000H0000000000000000000000H000
000H0000000000000000000000H000
000H0000000000000000000000H000
000H0000000000000000000000H000
000H0000000000000000000000H000
000H0000000000000000000000H000
000H0000000000000000000000H000
####0000000000000000000000####
