000000000000000000000000000000
000000000000000000000000000000
000000000000000000000000000000
000000000000000000000000000000
000000000000000000000000000000
000000000000000000000000000000
000000000000000000000000000000
000000000000000000000000000000
000H0000000@00000000@00000H000
000H######################H000
000H######################H000
000H######################H000
000H######################H000
000H######################H000
000H######################H000
000H######################H000
000H######################H000
000H######################H000
000H######################H000
##############################