000000000000000000000000000000
00000000000000000000000000@000
0000000000000000000000000####H
00000000000000000000000000000H
0000000000000000000000@000000H
00000000000000000000#####0000H
00000000000000000000000000000H
00000000000000000@00000000000H
000000000000000#####000000000H
00000000000000000000000000000H
000000000000@0000000000000000H
0000000000#####00000000000000H
00000000000000000000000000000H
0000000@000000000000000000000H
00000#####0000000000000000000H
00000000000000000000000000000H
00@00000000000000000000000000H
#####0000000000000000000000000
000000000000000000000000000000
000000000000000000000000000000