000000000000000000000000000000
000000000000000000000000000000
0000000000000000000000000####H
0000000000000000000000000####H
0000000000000000000000000####H
00000000000000000000#########H
00000000000000000000#########H
00000000000000000000#########H
000000000000000##############H
000000000000000##############H
000000000000000##############H
0000000000###################H
0000000000###################H
0000000000###################H
00000########################H
00000########################H
00000########################H
#############################H
000000000000000000000000000000
000000000000000000000000000000