000000000000000000000000000000
000000000000000000000000000@00
0000000000000000000000000####H
0000000000000000000000000####H
0000000000000000000000@00####H
00000000000000000000#########H
00000000000000000000#########H
00000000000000000@00#########H
000000000000000##############H
000000000000000##############H
000000000000@00##############H
0000000000###################H
0000000000###################H
0000000@00###################H
00000########################H
00000########################H
00@00########################H
#############################H
000000000000000000000000000000
000000000000000000000000000000