000000000000000000000000000000
000000000000000000000000000000
000000000000000000000000000000
00000000000000000H000000000000
#################H############
00000000000000000H000000000000
00000000000000000H000000000000
00000000000000000H000000000000
00000000000000000H000000000000
00000000000000000H000000000000
00000000000000000H000000000000
00000000000000000H000000000000
00000000000000000H000000000000
00000000000000000H000000000000
0000000000##########0000000000
0000000000##########0000000000
0000000000##########0000000000
#####00000##########00000#####
#####00000##########00000#####
#####00000##########00000#####