00000000000000000000000000@000
000000000000000000000000000000
000000000000000000000000000000
00000@00000000000H000000000000
#################H############
00000000000000000H000000000000
00000000000000000H000000000000
00000000000000000H000000000000
00000000000000000H000000000000
00000000000000000H000000000000
00000000000000000H000000000000
00000000000000000H000000000000
00000000000000000H000000000000
0000000000000@000H000000000000
0000000000##########0000000000
0000000000##########0000000000
00@0000000##########0000000@00
#####00000##########00000#####
#####00000##########00000#####
#####00000##########00000#####